22222222222222222222222222222222222222222222222222222222222222222222222222222222222222222222222222222222
2     K                                                                                                2
2                                                                                                      2
2                                                                                                      2
2               P                                      G                                               2
222222222222222                                                                                        2
2                                                                                                      2
2                       QQQQQQQ                 QQQQQQQQQQQQQQQQ    222222222   QQ                     2
2      K                                                                              2222222          2
2                                                                                                      2
2                                                                             Q                        2
22222222222222QQQQQQ                                                                 K                 2
2                                                                        QQ                            2
2                                                                                                      2
2                                                                              22222222222222          2
2                     G                                                                                2
2                                                                                                      2
2                              CCCCC                 2222222           QQQQQQ                          2
2              22222QQQQ22222                                                                          2
2                                                                                                      2
2                                                       QQQQQQQQ                  G                    2
2                K                                                  QQQ                                2
2                                                                          222222222222222222          2
2                            22      Q                           Q                                     2
2     M                    2222                                                        K               2
2                         22222                                                                        2
33333333333333333333333333333333333333333333333333333333333333333333333333333333333333333333333333333333
44444444444444444444444444444444444444444444444444444444444444444444444444444444444444444444444444444444